wwwwwwwwwwwwwwwwwwww
w000000000000000000w
w000000000000000000w
w000000000000000000w
w000000000000000000w
w000w00000000000000w
w000w000000c0000000w
w000w00000000000000w
wbd0w000s000cccccccw
wwwwwwwwwwwwwwwwwwww