wwwwwwwwwwwwwwwwwwww
w000000000000000000w
w000000000000000000w
w000000000000000000w
w000000000000000000w
w000w00000000000000w
w000w000000c0000000w
w000w00000000000000w
wb00w000s000cccccccw
wwwwwwwwwwwwwwwwwwww