wwwwwwwwwwwwwwwwwwww
w000000000000000000w
w000000000000000000w
w000000000000000000w
w000000000000000000w
w000d00000000000000w
w000p00000p00000000w
w000000p00000p00000w
w00000sssssssss0000w
wwwwwwwwwwwwwwwwwwww