wwwwwwwwwwwwwwwwwwww
w000000000000000000w
w000000000000000000w
w000000000000000000w
w000000000000000000w
w000d0000000000000dw
w000000pp00pp00000pw
w000p0000p00000p000w
wb0000000s000000000w
wwwwwwwwwwwwwwwwwwww