wwwwwwwwwwwwwwwwwwww
w000000000000000000w
w000000000000000000w
w00000000000000000dw
w000000000000000pppw
w000000000000pp0000w
w00000000pp00000000w
w00000pp00000000000w
w00pp00000000000000w
wwwwwwwwwwwwwwwwwwww