wwwwwwwwwwwwwwwwwwww
w000000000000000000w
w000000000000000000w
w000000000000000000w
w000c0000c0000c000dw
w000pp00pp000pp000pw
wpp00000000000000ppw
w000pp00pp0000pp000w
w000ssssssssssss000w
wwwwwwwwwwwwwwwwwwww